10 03 03 03 03 03 03 03 03 04
09 00 00 00 00 00 01 00 00 05
09 00 00 00 01 00 00 00 00 05
09 00 01 00 00 00 00 00 00 05
09 00 00 00 01 00 00 00 00 05
09 00 00 00 00 00 01 00 00 05
09 00 00 00 00 00 00 00 00 05
09 00 00 00 00 01 00 00 00 05
09 00 00 00 00 00 00 00 00 05
09 00 00 00 01 00 00 00 00 05
09 00 00 00 00 00 00 00 00 05
09 00 00 01 00 00 00 00 00 05
09 00 00 00 00 00 00 00 00 05
09 00 00 00 01 00 00 00 00 05
09 00 00 00 00 00 00 00 00 05
09 00 00 01 00 00 00 00 00 05
09 00 00 00 00 00 00 00 00 05
09 00 00 00 01 00 00 00 00 05
09 00 00 00 00 00 00 00 00 05
09 00 00 01 00 00 00 00 00 05
09 00 00 00 00 00 00 00 00 05
09 00 00 00 01 00 00 00 00 05
09 00 00 00 00 00 00 00 00 05
09 00 00 01 00 00 00 00 00 05
09 00 00 00 00 00 00 00 00 05
09 00 00 00 01 00 00 00 00 05
09 00 00 00 00 00 00 00 00 05
09 00 00 01 00 00 00 00 00 05
09 00 00 00 00 00 00 00 00 05
09 00 00 00 01 00 00 00 00 05
09 00 00 00 00 00 00 00 00 05
09 00 00 01 00 00 00 00 00 05
09 00 00 00 00 01 00 00 00 05
09 00 00 00 00 00 00 01 00 05
09 00 00 00 00 01 00 00 00 05
09 00 00 01 00 00 00 00 00 05
09 00 00 00 00 00 00 00 00 05
08 07 07 07 07 07 07 07 07 06
